XXXXXXXXXXXXXXXXXXXXXXXXXXXXXXXXXXXXXXXXXXXXXX
X                                            X
X XXXXXXXXXXXXXXXXXXXXXXXXXXXXXXXXXXXXXXXXXXXX
X X                                          S
X X XXXXXXXXXXXXXXXXXXXXXXXXXXXXXXXXXXXXXXXX X
X X                                        X X
X XXXXXXXXXXXXXXXXXXXXXXXXXXXXXXXXXXXXXXXX X X
X                                        X X X
X XXXXXXXXXXXXXXXXXXXXXXXXXXXXXXXXXXXXXX X X X
X                                      X X X X
X XXXXXXXXXXXXXXXXXXXXXXXXXXXXXXXXXXXX   X   X
X X                                  X X X X X
X XXXXXXXXXXXXXXXXXXXXXXXXXXXXXXXXXX X X X X X
X                                  X X X X X X
XXXXXXXXXXXXXXXXXXXXXXXXXXXXXXXXXX X X X X X X
X                                  X X X X X X
X XXXXXXXXXXXXXXXXXXXXXXXXXXXXXXXXXX X X X X X
X                                  X X X X X X
XXXXXXXXXXXXXXXXXXXXXXXXXXXXXXX XXXX X X X X X
X                                  X X X X X X
XX XXXXXXXXXXXXXXXXXXXXXXXXXXXXXXXX  X X X X X
X                                  X X X X X X
XXXXXXXXXXXXXXXXXXXXXXXXXXXXXXXXXX X X X X X X
X                                  X X X X X X
X XXXXXXXXXXXXXXXXXXXXXXXXXXXXXXXXXX X X X X X
X                                  X   X   X X
XXXXXXXXXXXXXXXXXXXXXXXXXXXXXXXXXXEXXXXXXXXXXX
