XSXXXXXXXXXXXXXXXXXXXXXXXXXXXXXXXXXXXXXXXXXXXX
X X     X                         X          X
X X     X           X             X        X X
X                   X                      X X
XXXXXXXXXXXXXXXXXXXXXXXXXXXXXXXXXXXXXXXXXX X X
X                                        X X X
X XXXXXXXXXXXXXXXXXXXXXXXXXXXXXXXXXXXXXX X X X
X                                      X XXX X
X XXXXXXXXXXXXXXXXXXXXXXXXXXXXXXXXXXXX   X   X
X X                                  X X X X X
X XXXXXXXXXXXXXXXXXXXXXXXXXXXXXXXXXX X X X X X
X                                  X X X X X X
XXXXXXXXXXXXXXXXXXXXXXXXXXXXXXXXXX X X X X X X
X                                  X X X X X X
X                       XXXXXXXXXXXX X X X X X
X                                  X X X X X X
XXXXXXXXXXXX                 XXXXXXX X X X X X
X                                  X X X X X X
XX XXXXXXXXXXXXXXXXXXXXXXXXXXXXXXXXX X X X X X
X                                  X X X X X X
XXXXXXXXXXXXXXXXXX                 X X X X X X
X                                  X X X X X X
X                    XXXXXXXXXXXXXXX X X X X X
X                                  X   X   X X
X                                  X   X   X X
XXXXXXXXXXXXXXXXXXXXXXXXXXXXXXXXXXEXXXXXXXXXXX
